Rich  bricks
EEE..EEEE..EEE
EEE..EEEE..EEE
EEE..EEEE..EEE
.....EEEE.....
.EEE......EEE.
.EEE..II..EEE.
.EEE..II..EEE.
..............
EE.II.EE.II.EE
EE.II.EE.II.EE
..............
E.HHHHHHHHHH.E
E.HNNNHHNNNH.E
..HNNNHHNNNH..
HHHNNNHHNNNHHH
NNNHHHHHHHHNNN
NNNH......HNNN
NNNH......HNNN
END.
You comment