Splash  waves
...E......E...
..EEE....EEE..
.EENEEIIEENEE.
EENINEEEENINEE
EN...NEEN...NE
N.....NN.....N
...H......H...
..HEH....HEH..
.HEEEHIIHEEEH.
HEEIEEHHEEIEEH
EE...EEEE...EE
E.....EE.....E
...H......H...
..HNH....HNH..
.HNNNHIIHNNNH.
HNNINNEENNINNE
NN...NNNN...NN
N.....NN.....N
END.
You comment