Square  love
...N......N...
..NNN....NNN..
.NNNNN..NNNNN.
.NHHNN..NNHHN.
.NHHNN..NNHHN.
NHHHHHNNHHHHHN
NHEEHENNEHEEHN
NHEEEEEEEEEEHN
NHEEHEEEEHEEHN
NNHEEEEEEEEHNN
.NHEEHEEHEEHN.
.NHEHHHHHHEHN.
.NNEHHHHHHENN.
..NEEHHHHEEN..
..NNEEHHEENN..
...NNEEEENN...
....NNNNNN....
......NN......
END.
You comment