EE...EEEEEE...EE
EE...EEEEEE...EE
EE...EEEEEE...EE
NN...EEEEEE...NN
NN...EEEEEE...NN
NN...EEEEEE...NN
NN...HHHHHH...NN
NN...NNHHNN...NN
NN...NNHHNN...NN
NN...HHHHHH...NN
NN...HHHHHH...NN
NN...HHHHHH...NN
NN...HHHHHH...NN
NN...EEEEEE...NN
NN...EEEEEE...NN
EE...EEEEEE...EE
EE...EEEEEE...EE
EE...EEEEEE...EE
EE...EEEEEE...EE
IIIIIIIIIIIIIIII
-
You comment