###.############.###
###.###......###.###
###.###.####.###.###
###.###.####.###.###
###.###......###.###
###.#####..#####.###
