EEEEEEEEEEEEEEEEEEEE
....................
NNNNNNNNNNNNNNNNNNNN
....................
HHHHHHHHHHHHHHHHHHHH
....................
IIIIIIIIIIIIIIIIIIII
-
