Square  love
..............
..NN......NN..
.N..NN..NN..N.
.N...N..N...N.
N.....NN.....N
N.....NN.....N
N............N
N............N
N............N
N............N
.N..........N.
.N..........N.
.N..........N.
.N..........N.
..N........N..
..N........N..
...N......N...
....N....N....
.....N..N.....
......NN......
-
You comment